15 15
5 5 5 5 5 5 5 5 5 5 5 5 5 5 5 
5 0 0 0 0 0 0 0 0 0 0 0 0 0 5 
5 0 0 0 5 0 5 0 0 0 0 5 0 0 5 
5 0 0 5 5 0 0 0 0 0 0 0 0 0 5 
5 0 0 5 0 0 0 0 0 0 0 0 0 0 5 
5 0 0 0 0 5 1 0 0 0 0 0 0 0 5 
5 0 0 0 0 0 0 0 5 0 0 0 0 0 5 
5 0 0 0 0 0 0 10 0 0 0 0 0 0 5 
5 0 5 0 0 0 0 0 0 5 0 0 5 0 5 
5 0 0 0 0 0 0 0 0 0 5 0 0 0 5 
5 0 0 0 0 0 5 0 0 0 0 0 0 0 5 
5 0 0 0 0 0 0 5 0 0 0 0 0 0 5 
5 0 0 0 0 0 0 0 0 5 0 0 0 0 5 
5 0 0 0 0 0 0 0 0 0 0 0 0 0 5 
5 5 5 5 5 5 5 5 5 5 5 5 5 5 5 
